3 3 3 3 3 3 3 3 3 3 3 3 3 3 3 3 3 3 3 3 3 3 3 3 3 3 3 3 3 3
3 1 1 1 1 1 1 1 1 1 1 1 1 1 1 1 1 1 1 1 1 1 1 1 1 1 1 1 5 3
3 1 3 3 3 3 3 1 3 3 3 3 3 3 1 3 3 3 3 3 3 1 3 3 3 3 3 3 1 3
3 1 3 3 3 3 3 1 3 3 3 3 3 3 9 3 3 3 3 3 3 1 3 3 3 3 3 3 1 3
3 1 3 3 3 3 3 1 3 3 3 3 3 3 1 3 3 3 3 3 3 1 3 3 3 3 3 3 1 3
3 1 3 3 3 3 3 1 3 3 3 3 3 3 1 3 3 3 3 3 3 1 3 3 3 3 3 3 1 3
3 1 3 3 3 3 3 1 3 3 3 3 3 3 1 3 3 3 3 3 3 2 3 3 3 3 3 3 1 3
3 1 1 1 1 1 1 1 1 1 1 1 1 1 1 1 1 1 1 1 1 1 2 1 1 1 1 1 1 3
3 1 3 3 3 3 3 1 3 3 3 3 3 3 1 3 3 3 3 3 3 1 3 3 3 3 3 3 1 3
3 1 3 3 3 3 3 1 3 3 3 3 3 3 1 3 3 3 3 3 3 1 3 3 3 3 3 3 1 3
3 1 3 3 3 3 3 1 3 3 3 3 3 3 1 3 3 3 3 3 3 1 3 3 3 3 3 3 1 3
3 1 3 3 3 3 3 1 3 3 3 3 3 3 1 3 3 3 3 3 3 1 3 3 3 3 3 3 1 3
3 1 3 3 3 3 3 2 3 3 3 3 3 3 1 3 3 3 3 3 3 1 3 3 3 3 3 3 1 3
3 1 3 3 3 3 3 1 3 3 3 3 3 3 1 3 3 3 3 3 3 1 3 3 3 3 3 3 1 3
3 1 1 1 1 1 1 1 1 1 1 1 1 1 1 1 1 1 1 1 1 1 1 1 1 1 1 1 1 3
3 1 3 3 3 3 3 1 3 3 3 3 3 3 1 3 3 3 3 3 3 1 3 3 3 3 3 3 1 3
3 1 3 3 3 3 3 1 3 3 3 3 3 3 1 3 3 3 3 3 3 1 3 3 3 3 3 3 1 3
3 1 3 3 3 3 3 1 3 3 3 3 3 3 1 3 3 3 3 3 3 1 3 3 3 3 3 3 1 3
3 1 3 3 3 3 3 1 3 3 3 3 3 3 1 3 3 3 3 3 3 1 3 3 3 3 3 3 1 3
3 1 3 3 3 3 3 1 3 3 3 3 3 3 1 3 3 3 3 3 3 1 3 3 3 3 3 3 1 3
3 1 3 3 3 3 3 1 3 3 3 3 3 3 1 3 3 3 3 3 3 1 3 3 3 3 3 3 1 3
3 1 1 1 2 1 1 1 1 1 1 1 1 1 1 1 1 9 1 1 1 1 1 1 1 1 1 1 1 3
3 1 3 3 3 3 3 1 3 3 3 3 3 3 9 3 3 3 3 3 3 1 3 3 3 3 3 3 1 3
3 1 3 3 3 3 3 1 3 3 3 3 3 3 1 3 3 3 3 3 3 1 3 3 3 3 3 3 1 3
3 1 3 3 3 3 3 2 3 3 3 3 3 3 1 3 3 3 3 3 3 1 3 3 3 3 3 3 1 3
3 9 3 3 3 3 3 1 3 3 3 3 3 3 1 3 3 3 3 3 3 1 3 3 3 3 3 3 1 3
3 1 3 3 3 3 3 2 3 3 3 3 3 3 1 3 3 3 3 3 3 1 3 3 3 3 3 3 1 3
3 1 3 3 3 3 3 1 3 3 3 3 3 3 1 3 3 3 3 3 3 1 3 3 3 3 3 3 1 3
3 1 1 1 1 1 2 1 1 1 1 1 1 1 1 1 1 1 1 1 1 1 1 1 1 1 1 1 1 3
3 3 3 3 3 3 3 3 3 3 3 3 3 3 3 3 3 3 3 3 3 3 3 3 3 3 3 3 3 3